JTTTTTTTTTTTTTTTTTTTTTTTTTTTTTTK
LFFFFFFFFFFFFFFFFFFFFFFFFFFFFFFR
LFFFFFFFFFFFFFFFFFFFFFFFFFFFFFFR
LFFFFFFFFFFFFFFFFFFFFFFFFFFFFFFR
LFFFFFFFFFFFFFFFFFFFFFFFFFFFFFFR
LFFRBLFFFFFFFFFFFFFFFFFFFFFFFFFR
LFFRBLFFFFFFFFFFFFFFFFFFFFFFFFFR
LFFRBHDDDDDDDDDDDDDDDDDDDDFFFFFR
LFFRBJTTTTTTTTTTTTTTTTTTTTFFFFFR
LFFRBLFFFFFFFFFFFFFFFFFFFFFFFFFR
LFFRBLFFFFFFFFFFFFFFFFFFFFFFFFFR
LFFRBLFFFFFFFFFFFFFFFFFFFFFFFFFR
LFFRBLFFFFFFFFFFFFFFFFFFFFFFFFFR
LFFRBLFFFFFFFFFFFFFFFFFFFFFFFFFR
LFFRBLFFFFFFFFFFFFFFFFFFFFFFFFFR
LFFRBLFFFFFFFFFFFFFFFFFFFFFFFFFR
LFFRBHDDDDDDDDDDDDDDDDDDDDFFFFFR
LFFRBJTTTTTTTTTTTTTTTTTTTTFFFFFR
LFFRBLFFFFFFFFFFFFFFFFFFFFFFFFFR
LFFFFFFFFFFFFFFFFFFFFFFFFFFFFFFR
LFFFFFFFFFFFFFFFFdFFFFFFFFFFFFFR
LFFFFFFFFFFFFFFFFFFFFFFFFFFFFFFR
LFFFFFFFFFFFFFFFFFFFFFFFFFFFFFFR
HDDDDDDDDDDDDDDDDDDDDDDDDDDDDDDI