JTTTTTTTTTTTTTTTTTTTTTTTTTTTTTTK
LFFFFFbFFFFFFFFFFFFFFFFFFbFFFFFR
LFFFFFbFFFFFFFFFFFFFFFFFFbFFFFFR
LFFFFFbFFFFFFFFFFFFFFFFFFbFFFFFR
LFFFODPFFFFFFFFFFFFFFFFFFODPFFFR
LFFFRBLFFFFFFFFFFFFFFFFFFRBLFFFR
LFFFMTNFFFFFFFFFFFFFFFFFFMTNFFFR
LFFFFFFFFFFFFFFFFFFFFFFFFFFFFFFR
LFFFFFFFFFFFFFFbbFFFFFFFFFFFFFFR
LFFFFFFFFFFFFFFbbFFFFFFFFFFFFFFR
LFFFFFFFFFFFFFFbbFFFFFFFFFFFFFFR
LbbbODDDDDDDDDDDDDDDDDDDDDDPbbbR
LbbbMTTTTTTTTTTTTTTTTTTTTTTNbbbR
LFFFFFFFFFFFFFFbbFFFFFFFFFFFFFFR
LFFFFFFFFFFFFFFbbFFFFFFFFFFFFFFR
LFFFFFFFFFFFFFFbbFFFFFFFFFFFFFFR
LFFFFFFFFFFFFFFFFFFFFFFFFFFFFFFR
LFFFODPFFFFFFFFFFFFFFFFFFODPFFFR
LFFFRBLFFFFFFFFFFFFFFFFFFRBLFFFR
LFFFMTNFFFFFFFFFFFFFFFFFFMTNFFFR
LFFFFFbFFFFFFFFFFFFFFFFFFbFFFFFR
LFFFFFbFFFFFFFFFFFFFFFFFFbFFFFFR
LFFFFFbFFFFFFFFFFFFFFFFFFbFFFFFR
HDDDDDDDDDDDDDDDDDDDDDDDDDDDDDDI