JTTTTTTTTTTTTTTTTTTTTTTTTTTTTTTK
LFFFFFFFFFFFFFFFFFFFFFFFFFFFFFFR
LFFFFFFFFFFFFFFFFFFFFFFFFFFFFFFR
LFFFFFFFFFFFFFFFFFFFFFFFFFFFFFFR
LFFFFFFOPFFFSSSSSSSSFFFOPFFFFFFR
LFFFFFFRLFFFFFFFFFFFFFFRLFFFFFFR
LFFFFFFRLFFFFFFFFFFFFFFRLFFFFFFR
LFFFFFFRLFFFFFFFFFFFFFFRLFFFFFFR
LFFFFFFRLFFFFFFFFFFFFFFRLFFFFFFR
LFFFFFFRLFFFFFFFFFFFFFFRLFFFFFFR
LFFFFFFRHDDDDDDDDDDDDDDILFFFFFFR
LFFFFFFRJTTTTTTTTTTTTTTKLFFFFFFR
LFFFFFFRLFFFFFFFFFFFFFFRLFFFFFFR
LFFFFFFRLFFFFFFFFFFFFFFRLFFFFFFR
LFFFFFFRLFFFFFFFFFFFFFFRLFFFFFFR
LFFFFFFRLFFFFFFFFFFFFFFRLFFFFFFR
LFFFFFFRLFFFSSSSSSSSFFFRLFFFFFFR
LFFFFFFMNFFFFFFFFFFFFFFMNFFFFFFR
LFFFFFFFFFFFFFFFFFFFFFFFFFFFFFFR
LFFFSSSSSFFFFFFFFFFFFFFSSSSSFFFR
LFFFSSSSSFFFFFFFFFFFFFFSSSSSFFFR
LFFFSSSSSFFFFFFFFFFFFFFSSSSSFFFR
LFFFFFFFFFFFFFFFFFFFFFFFFFFFFFFR
HDDDDDDDDDDDDDDDDDDDDDDDDDDDDDDI