JTTTTTTTTTTTTTTTTTTTTTTTTTTTTTTK
LFFFFFFFFFFFFFFFFFFFFFFFFFFFFFFR
LFFFFFFFFFFFFFFFFFFFFFFFFFFFFFFR
LFFFFFFFFFFFFFFFFFFFFFFFFFFFFFFR
LFFFFFFOPFFFFFFFFFFFFFFOPFFFFFFR
LFFFFFFRLFFFFFFFFFFFFFFRLFFFFFFR
LFFFFFFRLFFFFFFFFFFFFFFRLFFFFFFR
LFFFFFFRLFFFFFFFFFFFFFFRLFFFFFFR
LFFFFFFRLFFFFFFFFFFFFFFRLFFFFFFR
LFFFFFFRLFFFFFFFFFFFFFFRLFFFFFFR
LFFFFFFRHDDDDDDDDDDDDDDILFFFFFFR
LFFFFFFRJTTTTTTTTTTTTTTKLFFFFFFR
LFFFFFFRLFFFFFFFFFFFFFFRLFFFFFFR
LFFFFFFRLFFFFFFFFFFFFFFRLFFFFFFR
LFFFFFFRLFFFFFFFFFFFFFFRLFFFFFFR
LFFFFFFRLFFFFFFFFFFFFFFRLFFFFFFR
LFFFFFFRLFFFFFFFFFFFFFFRLFFFFFFR
LFFFFFFMNFFFFFFFFFFFFFFMNFFFFFFR
LFFFFFFFFFFFFFFFFFFFFFFFFFFFFFFR
LFFFFFFFFFFFFFFFFFFFFFFFFFFFFFFR
LFFFFFFFFFFFFFFFFFFFFFFFFFFFFFFR
LFFFFFFFFFFFFFFFFFFFFFFFFFFFFFFR
LFFFFFFFFFFFFFFFFFFFFFFFFFFFFFFR
HDDDDDDDDDDDDDDDDDDDDDDDDDDDDDDI