JTTTTTTTTTTTTTTTTTTTTTTTTTTTTTTK
LSSSSSSSSSSSSSSSSSSSSSSSSSSSSSSR
LSFFFFFFFFFSFFFFFFFFFSFFFFFFFFSR
LSFFFFFFFFFFFFFFFFFFFFFFFFFFFFSR
LSFFFFFFFFFFFFFFFFFFFSFFFFFFFFSR
LSFFFFFFFSSSFFFFFFFFFSFFFFFFFFSR
LSFFFFFFFSFFFFFFFFFFFSFFFFFFFFSR
LSSSSFFFSSFFFFFFFFFFFSSFSSFFFFSR
LSFFFFFFFFFFFFFFFFFFFFFFFSFFFFSR
LSFFFFFFFFFFFFFFFFFFFFFFFFFFFFSR
LSFFFFFFFFFFFFFFFFFFFFFFFFFFFFSR
LSFFFFFFFFFFFFFFFFFFFFFFFSFFFFSR
LSFFFFFFFFFFFFFFFFFFFFFFFSSFFFSR
LSFFFFFFFFFFFFFFFFFFFFFFFFSFFSSR
LSFFFFFFFFFFFFFFFFFFFFFFFFFFFFSR
LSFFFFFFFFFFFFFFFFFFFFFFFFFFFFSR
LSFFFFFFFFFFFFFFFFFFFFFFFFFFFFSR
LSSSFFFFSSSSSSSSSSFFFFFFFFFFFFSR
LSFFFFFFFFFFFFFFFSFFFFFFFFFFFFSR
LSFFFFFFFFFFFFFFFSSSSFFFFSSSSSSR
LSFFFFFFFFFFFFFFFFFFFFFFFSSSSSSR
LSFFFFFFFFFFFFFFFFFFFFFFFSSSSSSR
LSSSSSSSSSSSSSSSSSSSSSSSSSSSSSSR
HDDDDDDDDDDDDDDDDDDDDDDDDDDDDDDI