JTTTTTTTTTTTTTTTTTTTTTTTTTTTTTTK
LFFFFFFFFFFFFFFFFFFFFFFFFFFFFFFR
LFFFFFFFFFFFFFFFFFFFFFFFFFFFFFFR
LFFFFFFFFFFFFFFFFFFFFFFFFFFFFFFR
LFFFODPFFFFFFFFFFFFFFFFFFODPFFFR
LFFFRBLFFFFFFFFFFFFFFFFFFRBLFFFR
LFFFMTNFFFFFFFFFFFFFFFFFFMTNFFFR
LFFFFFFFFFFFFFFFFFFFFFFFFFFFFFFR
LFFFFFFFFFFFFFFFFFFFFFFFFFFFFFFR
LFFFFFFFFFFFFFFFFFFFFFFFFFFFFFFR
LFFFFFFFFFFFFFFFFFFFFFFFFFFFFFFR
LFFFODDDDDDDDDDDDDDDDDDDDDDPFFFR
LFFFMTTTTTTTTTTTTTTTTTTTTTTNFFFR
LFFFFFFFFFFFFFFFFFFFFFFFFFFFFFFR
LFFFFFFFFFFFFFFFFFFFFFFFFFFFFFFR
LFFFFFFFFFFFFFFFFFFFFFFFFFFFFFFR
LFFFFFFFFFFFFFFFFFFFFFFFFFFFFFFR
LFFFODPFFFFFFFFFFFFFFFFFFODPFFFR
LFFFRBLFFFFFFFFFFFFFFFFFFRBLFFFR
LFFFMTNFFFFFFFFFFFFFFFFFFMTNFFFR
LFFFFFFFFFFFFFFFFFFFFFFFFFFFFFFR
LFFFFFFFFFFFFFFFFFFFFFFFFFFFFFFR
LFFFFFFFFFFFFFFFFFFFFFFFFFFFFFFR
HDDDDDDDDDDDDDDDDDDDDDDDDDDDDDDI