JTTTTTTTTTTTTTTTTTTTTTTTTTTTTTTK
LFFFFFFFFFFFFFFFFFFFFFFFFFFFFFFR
LFSSSSSSSSSSSSSSSSSSSSSSSSSSSSFR
LFSFFFFFFFFFFFFFFFFFFFFFFFFFFSFR
LFSFbbbbbbbbbbbbbbbbbbbbbbbbFSFR
LFSFbSSSSSSSSSSSSSSSSSSSSSSbFSFR
LFSFbSFFFFFFFFFFFFFFFFFFFFSbFSFR
LFSFbSFFFFFFFFFFFFFFFFFFFFSbFSFR
LFSFbSFFFFFFFFFFFFFFFFFFFFSbFSFR
LFSFbSFFFbbbbbbbbbbbbbbFFFSbFSFR
LFSFbSFFFbFFFFFFFFFFFFbFFFSbFSFR
LFSFbSFFFbFFFFFFFFFFFFbFFFSbFSFR
LFSFbSFFFbFFFFFFFFFFFFbFFFSbFSFR
LFSFbSFFFbFFFFFFFFFFFFbFFFSbFSFR
LFSFbSFFFbbbbbbbbbbbbbbFFFSbFSFR
LFSFbSFFFFFFFFFFFFFFFFFFFFSbFSFR
LFSFbSFFFFFFFFFFFFFFFFFFFFSbFSFR
LFSFbSFFFFFFFFFFFFFFFFFFFFSbFSFR
LFSFbSSSSSSSSSSSSSSSSSSSSSSbFSFR
LFSFbbbbbbbbbbbbbbbbbbbbbbbbFSFR
LFSFFFFFFFFFFFFFFFFFFFFFFFFFFSFR
LFSSSSSSSSSSSSSSSSSSSSSSSSSSSSFR
LFFFFFFFFFFFFFFFFFFFFFFFFFFFFFFR
HDDDDDDDDDDDDDDDDDDDDDDDDDDDDDDI