JTTTTTTTTTTTTTTTTTTTTTTTTTTTTTTK
LSSSSSSSSSSSSSSSSSSSSSSSSSSSSSSR
LSFFFFFFFFFSFFFFFFFFFFFFFFFFFFSR
LSFFFFFFFFFbFFFFFFFFFFFFFFFFFFSR
LSFFFFFFFFFbFFFFFFFFFFFFFFFFFFSR
LSFFFFFFFSSSFFFFFFFFFFFFFFFFFFSR
LSFFFFFFFSFFFFFFFFFFFFFFFFFFFFSR
LSSSSSbbSSFFFFFFFFFFFFFFFFFFFFSR
LSFFFFFFFFFFFFFFFFFFFFFFFFFFFFSR
LSFFFFFFFFFFFFFFFFFFFFFFFFFFFFSR
LSFFFFFFFFFFFFFFFFFFFFFFFFFFFFSR
LSFFFFFFFFFFFFFFFFFFFFFFFFFFFFSR
LSFFFFFFFFFFFFFFFFFFFFFFFFFFFFSR
LSFFFFFFFFFFFFFFFFFFFFFFFFFFFFSR
LSFFFFFFFFFFFFFFFFFFFFFFFFFFFFSR
LSFFFFFFFFFFFFFFFFFFFFFFFFFFFFSR
LSFFFFFFFFFFFFFFFFFFFFFFFFFFFFSR
LSSSSSSSSSSSSSSSSSFFFFFFFFFFFFSR
LSFFFFFFFFFFFFFFFSFFFFFFFFFFFFSR
LSFFFFFFFFFFFFFFFSSSSFFFFFFFFFSR
LSFFFFFFFFFFFFFFFFFFbFFFFFFFFFSR
LSFFFFFFFFFFFFFFFFFFbFFFFFFFFFSR
LSSSSSSSSSSSSSSSSSSSSSSSSSSSSSSR
HDDDDDDDDDDDDDDDDDDDDDDDDDDDDDDI