JTTTTTTTTTTTTTTTTTTTTTTTTTTTTTTK
LFFFFFFSSFFFFFFFFFFFFFFSSFFFFFFR
LFFFFFFFFFFFFFFFFFFFFFFFFFFFFFFR
LFFFFFFSSFFFFFFFFFFFFFFSSFFFFFFR
LSFFSFFFFFFFFFFFFFFFFFFFFFFSFFSR
LFSFFSFOPSFFFFFFFFFFFFSOPFSFFSFR
LFFSFFSRLSSFFFFFFFFFFSSRLSFFSFFR
LFFFSFFRLSSSFFFFFFFFSSSRLFFSFFFR
LFFFFSFRLSSSSFFFFFFSSSSRLFSFFFFR
LFFFSFFRLSSSSSFFFFSSSSSRLFFSFFFR
LFFSFFSRLSSSSSSSSSSSSSSRLSFFSFFR
LFSFFSFRHDDDDDDDDDDDDDDILFSFFSFR
LSFFSFFRJTTTTTTTTTTTTTTKLFFSFFSR
LFFSFFFRLSSSSSSSSSSSSSSRLFSFFSFR
LFSFFFFRLSSSSSFFFFSSSSSRLSFFSFFR
LFFSFFFRLSSSSFFFFFFSSSSRLFFSFFFR
LSFFSFFRLSSSFFFFFFFFSSSRLFSFFFFR
LFSFFSFRLSSFFFFFFFFFFSSRLFFSFFFR
LFFSFFSMNSFFFFFFFFFFFFSMNSFFSFFR
LFFFFFFSSFFFFFFFFFFFFFFSSFFFFFFR
LFFFFFFFFFFFFFFFFFFFFFFFFFFFFFFR
LFFFFFFSSFFFFFFFFFFFFFFSSFFFFFFR
LFFFFFFFFFFFFFFFFFFFFFFFFFFFFFFR
HDDDDDDDDDDDDDDDDDDDDDDDDDDDDDDI