JTTTTTTTTTTTTTTTTTTTTTTTTTTTTTTK
LSSSSSSSSSSSSSSSSSSSSSSSSSSSSSSR
LSFFFFFFFFFSFFFFFFFFFSFFFFFFFFSR
LSFFFbFFFFFbFFFFFFFFFbFFFbFFFFSR
LSFFFFFFFFFbFFFFFFFFFSFFFFFFFFSR
LSFbFFFFFSSSFFFFFbFFFSFFFFFFFFSR
LSFFFFFFFSFFFFFFFFFFFSFFFFFFFFSR
LSSSSSbbSSFFFFFFFFFFFSSbSSFFFFSR
LSFFFFFFFFFFbFFFFFFbFFFFFSFFFFSR
LSFFFFFFFFFFFFFFFFFFFFFFFSFFFFSR
LSFFFbFFFFFSSSSFFSSSSFFFFSFFFFSR
LSFFFFFFFFFbFFFFFFFFbFFFFSFFFFSR
LSFFFFFFFFFbFFFFFFFFbFFFFSSFFFSR
LSFFFFFFFFFSFFFFFFFFSFFFFFSbbSSR
LSFFFFFFFFFSSSSSSSSSSFFFFFFFFFSR
LSFFFFFbFFFFFFFFFFFFFFFFbFFFFFSR
LSFFFFFFFFFFFFFFFFFFFFFFFFFFFFSR
LSSSbbSSSSSSSSSSSSFFFbFFFFFFFFSR
LSFFFFFFFFFFFFFFFSFFFFFFFFFFFFSR
LSFFFFFFFFFFFbFFFSSSSFFFFSSSSSSR
LSFFFFbFFFFFFFFFFFFFbFFFFSSSSSSR
LSFFFFFFFFFFFFFFFFFFbFFFFSSSSSSR
LSSSSSSSSSSSSSSSSSSSSSSSSSSSSSSR
HDDDDDDDDDDDDDDDDDDDDDDDDDDDDDDI